17
11
9
XXXXXXXXXXXXXXXXX
X    @          X
X               X
X   **     *    X
X          *    X
X               X
X  .     *      X
X .*.   *X*     X
X  .     *      X
X               X
XXXXXXXXXXXXXXXXX