7
6
3
 XXXXX 
X  @  X
X *** X
X ... X
X     X
 XXXXX 
