6
6
1
XXXXX
X @ X
X * X
X . X
XXXXX